############
#    P     #
#      O####
#          #
######     #
#   ##     #
#  O##     #
#          #
#       XX #
#       #  #
############
